W W W W W W W W W W W W W W W W W W W W W
W W W W W 0 0 0 0 W W W W W W W W W W W W
W W W W W 0 P 0 0 0 A 0 0 0 0 W W W W W W
W W W W W 0 0 A K W W W H 0 K W W W W W W
W W W W W 0 0 0 0 W W W W 0 W W W W W W W
W W W W W W W D W W W W W 0 W W W W W W W
W W W W W W W 0 W 0 0 0 W 0 W W W W W W W
W W W W W W W 0 0 0 0 0 0 0 W W W W W W W
W W W W W W W W W 0 0 0 W W W W W W W W W
W W W W W W W W W W D W W W W W W W W W W
W W W W W W W W W W 0 W W W W W W W W W W
W W W W W W W W W W 0 W W W W W W W W W W
W W W W W W W W W W 0 W W W W W W W W W W
W W W W W W W W W W 0 W W W W W W W W W W
W W W W W W W W W W 0 W W W W W W W W W W
W W W W W 0 0 0 0 0 0 0 0 0 0 0 W W W W W
W W W W W 0 0 E 0 0 0 0 0 0 0 0 W W W W W
W W W W W 0 0 0 0 0 0 0 0 0 0 0 W W W W W
W W W W W 0 0 0 0 0 0 0 0 E 0 0 W W W W W
W W W W W 0 0 0 E 0 0 0 0 0 0 0 W W W W W
W W W W W 0 0 0 0 0 0 0 0 0 0 0 W W W W W
W W W W W W W W W W W W W W W W W W W W W